green
12
12
############
#:...B..T###
#........###
#T.#.###..##
##x#...#..##
#T.....#..T#
#......#...#
#.#....##..#
#.##..###..#
#.###.###..#
#.........T#
############