red
11
12
############
###....T...#
###.##.T.#.#
####.......#
###x.#.#.#.#
#.#.##.#.#.#
#.#:##.#.###
#......#..##
#.#..B....##
#....#######
############