blue
12
12
#TTT########
#...##..B..#
#.#........#
#....#.###.#
##.###.....#
#....#..#.##
#..#....#..#
##.........#
#..TT...#..#
#..TT.#.#.##
#:....#...##
############